1111111
1P000C1
1000001111
1001111
1001001
1C010E1
1111111
