1111111
1P000C1
1000001
10T0001
1000001
1C000E1
1111111
