1111111
1P000C1
1000001
100C001
1000001
1C000E1
1111111
1000001
1010101
1011001
1010001
1011001
1010101
1000001
1111111